maan	ittihad	gk
amr	ahli	m
holy	ittifaq	d
player	wahda	m
moe	ahli	m
hashim	ahli	f
jessica	ittihad	m
timmy	nasr	d
tawsif	hilal	gk
kor	ahli	d
tor	wahda	f
thor	ittihad	f
loke	city	m
batty	utd	d
fatty	barcelona	d
dayum	ittihad	m
messi	ahli	m
ronaldo	ittihad m
torres ahli	f
player ittihad	gk
